XXXXXXXXXXXXXXXXXXXXXXXXXXXXXXXXXXXXXXXXXXXXXXXXXXXXXXXXXXXXXXXXXXXXXXXXXXXXXXXXXXXXXXXXXXXXXXXXXXXXXXXXXXXXXXXXXXXXXXXXXXXXXXXXXXXXXXXXXXXXXXXXXXXXXXXXXXXXXXXXXXXXXXXXXXXXXXXXXXXXXXXXXXXXXXXXXXXXXXXXX
X   X X X X   X       X   X   X X   X X           X X     X X   X       X X       X   X X X X       X     X X X       X X       X X       X             X X       X     X     X X X   X X     X     X   X
XXX X X X XXX X X X X X XXX XXX X XXX X XXX XXX X X X XXXXX X XXX XXX XXX X XXX XXX X X X X XXXXXXX X XXX X X X XXXXXXX XXX XXXXX XXXXX X XXX XXXXX XXXXX XXX XXXXXXX XXX XXXXX X X XXX XXX X X X XXX XXX
X   X           X X X X         X   X     X X   X X     X   X X   X X     X X     X X X     X     X X X   X       X           X X X   X X X X   X           X   X     X         X X         X   X     X X
XXX XXXXXXXXXXX XXXXX X XXX XXX X X X XXX XXX X X X X XXX X X X X X X X X XXX XXXXX X XXX XXX X XXX X X XXXXX XXXXX XXXXX XXXXX X X XXX XXX XXX XXXXX XXX X X XXX XXX X XXX X XXX XXXXXXX XXX XXX XXXXX X
X   X X X     X   X     X X   X   X   X X   X X X   X     X   X X X   X X X   X     X   X   X X     X X X       X     X     X X     X X     X X X X X X X X         X X X   X   X X     X X X   X   X   X
X X X X X X XXXXXXXXX XXX XXXXXXXXX XXX XXX XXX XXX XXXXX X X XXX X XXXXXXXXX X X XXX X XXX X XXXXXXX X XXXXX X XXXXXXX XXX X X X X X XXX XXX X X X XXX XXXXXXXXX XXXXX XXXXX XXX XXX XXXXX XXXXX XXXXX X
X X   X   X     X   X X       X   X       X X X X X     X X X     X X   X X X   X X X X     X     X   X       X   X     X     X X X X     X   X X X X X   X X X   X   X   X X   X     X   X X     X     X
XXXXX X XXXXX X XXX X X X X XXX XXXXX XXX X X XXX XXX XXXXXXX XXXXXXX X X X XXXXXXX X XXXXX X XXXXX XXXXXXX XXXXX X X XXXXX XXX XXX X X X XXX X X X X X X X X X X XXX X X X X XXXXX X X XXX XXXXX X XXX X
X     X X   X X X       X X X   X       X X       X     X       X   X X             X X   X X     X     X     X   X X   X X X   X X   X X       X       X   X   X       X   X       X     X X X   X   X X
X X XXXXXXX X XXXXXXX X XXX XXX X XXX XXX X XXXXX XXXXXXX XXXXX XXX X XXX X XXX XXX X X XXXXXXXXX XXX X XXXXXXX XXX XXX X XXX XXX XXXXX XXX X XXX X X XXXXX X XXXXXXXXX XXX XXXXX XXXXX X X X X XXX XXXXX
X X       X           X X     X     X X X X X X X X X   X   X X   X X X   X   X X   X           X   X X   X   X     X         X     X     X X X X X X X   X   X   X     X   X X X   X X X       X   X   X
X X X XXX X X XXXXXXXXX XXXXX X XXX X X X XXX X XXX X XXX XXX X X X X XXX XXX XXX XXXXXXX XXX XXX X XXXXX X XXXXX X X XXX XXXXX X X X XXX XXXXX XXXXX X X XXXXX XXXXX X XXXXX X XXXXX XXXXXXX X X X X XXX
X X X   X   X X X           X X   X X X X     X   X     X X     X X   X X X X X         X X   X X X     X X   X   X X   X   X X X X X X     X   X       X   X X X     X   X         X     X   X   X X   X
X XXX X X XXX X X XXXXXXX XXXXXXX XXXXX XXX XXX XXX XXXXXXXXXXXXX XXX X XXX X XXXXXXX XXXXX XXX XXX XXXXXXX XXX X X XXX XXXXX XXXXX XXXXXXXXXXX XXX XXXXXXX X X X X XXX XXXXX XXX XXX XXX XXX XXXXX XXX X
X X   X X X X X         X X     X   X X   X X   X   X     X   X     X       X X   X X     X           X     X X X X   X X X         X       X X     X   X X   X   X X X X     X X       X X   X   X     X
XXX X XXXXX XXX X XXXXXXX X XXXXXXX X XXX XXXXX X XXXXXXX X XXXXX XXX XXXXXXX XXX X X XXXXXXXXXXX XXX X X XXX XXX X X X X X X XXXXX X X X XXX XXX X X X X XXX XXXXXXX XXXXXXX X XXX XXX X X X X XXXXX X X
X   X X X     X X   X   X     X       X   X         X X   X X X X X X X     X   X X   X   X         X   X X       X X X X   X   X     X X X     X X X X       X   X         X X     X   X X X X     X X X
XXX X X X XXXXX X XXXXX XXX XXXXX XXXXX XXXXXXXXX X X XXX X X X XXX XXX XXXXX X X XXX XXX X X XXX XXX XXX X X X XXXXX XXXXXXXXX XXXXXXXXXXXXX X XXXXX XXXXXXX XXX X XXX XXX X XXX XXXXXXXXX X XXX XXXXXXX
X   X     X   X X       X X   X               X X X   X   X     X   X         X   X X X     X   X X     X   X X X X     X   X     X       X   X     X X   X   X     X     X X X       X X X X   X       X
X X XXXXX X XXX X XXX XXX X X XXXXXXXXX XXXXX X X XXX XXX XXX XXX XXXXXXXXXXXXX X X X X X XXXXXXX XXX XXX XXX XXX XXXXX X XXX XXXXX X X XXX X XXX XXX X X XXXXXXXXX XXXXX XXXXX XXX X X X XXXXX XXX X XXX
X X     X X     X X X   X   X X   X         X X   X X X     X     X       X     X   X X X X   X X X   X X X   X       X X     X   X X X   X X   X   X   X X         X           X   X X       X X X X   X
XXXXX XXXXX X XXXXX XXXXXXX X XXX X X X XXX X X XXX XXX XXXXX XXXXX X XXX X X X XXXXXXXXXXX X X XXX XXX X XXXXXXX X X X X XXX X XXXXX XXX X X XXXXXXXXXXX XXXXX X XXXXX X XXX X XXX XXX XXXXX X X X XXXXX
X   X X     X X   X X   X   X     X X X X   X       X         X X   X   X   X X             X X     X         X   X X X   X   X         X X X X     X     X X X X     X X X   X   X X     X X           X
X XXXXXXX XXXXX XXX X XXXXXXXXX X X XXXXX X XXX XXX XXXXX X X X XXXXXXX XXXXXXXXXXX X XXXXX X X X XXXXXXXXX XXXXX XXXXX XXX XXX XXX XXXXX X X X XXX XXX XXX X XXXXXXX X XXXXXXX X X X XXXXX X XXX X X XXX
X     X     X       X     X     X X X   X X   X X     X X X X X         X X X X     X X   X X X X       X   X X X   X   X X   X   X   X X   X   X     X X     X X X   X     X   X X X   X   X   X X X   X
X XXXXXXXXX X XXXXXXXXXXX XXX XXXXX XXX X XXXXXXX XXXXX XXX X XXX X XXX X X X X XXXXX X XXX X XXXXXXX XXXXXXX X X XXXXXXX XXX XXX XXXXX XXX XXX X XXXXXXX XXX X X XXX XXXXXXXXXXX XXXXXXX X X X X XXX X X
X X   X X   X X       X     X   X     X   X   X           X X   X X   X       X X   X X     X     X X X   X X   X   X   X     X X         X   X X X   X     X X   X X X   X X   X       X X X X X X X X X
X X XXX XXX X X XXXXXXX X XXXXXXX X XXX XXX XXXXX XXX X XXXXX XXXXXXX XXX XXXXXXX X X XXXXXXX XXXXX XXX XXX X X XXX X XXXXX X X X XXX X XXXXX XXXXX XXX X XXX XXX X X X XXX XXX X X XXXXX XXXXX X X XXXXX
X             X X       X       X X X X         X   X X X     X   X     X     X X X X X X             X       X X           X X X X X X X       X     X X   X       X   X X   X X X   X X     X X     X X
X XXX XXX XXXXX XXXXXXX XXXXXXXXXXXXX X XXXXX XXXXX X XXX X XXX XXX XXX X XXX X XXX XXX X X XXX X XXXXX XXXXXXXXX XXXXXXXXX XXX X X X XXXXXXX XXXXX X XXX XXX XXX XXX X X X X X X XXXXX XXX XXXXX XXX X X
X   X X X X     X   X X   X             X X X X   X X X X X X   X X X   X X   X       X X X   X X       X     X       X     X X X X X   X       X   X       X X X     X X   X   X X       X     X X   X X
X XXXXX XXX XXX XXX X X X X XXXXXXXXXXXXX X X X X XXXXX X XXX XXX XXX XXXXX XXXXX X XXX X X XXXXX XXXXXXXXXXX XXXXX XXX XXX X X XXX XXXXXXX XXXXXXXXXXX XXXXX X XXXXXXXXX XXXXX XXX X XXX X XXXXX XXX X X
X     X X   X X   X     X   X X     X X     X   X   X X   X   X     X X         X X X     X   X     X   X     X X   X   X         X     X X     X   X   X X     X X X     X       X X X X X     X X     X
X XXX X X XXX X X X XXXXXXX X X XXXXX XXXXX XXXXXXX X X XXXXX X XXXXX XXXXXXX XXX XXX X X XXXXXXX XXX XXX XXX X XXXXXXX XXXXXXXXXXXXX X X X XXX X X XXX X XXXXX X X X XXX XXXXXXX X XXX XXX XXXXX XXX XXX
X X     X   X   X   X   X X       X     X X     X X     X   X       X X     X X   X   X X     X   X     X X         X     X     X     X X     X   X   X X     X       X       X       X X X   X X X   X X
X XXXXXXXXXXXXX XXXXXXX X X XXXXX XXX X X XXXXX X X X XXX X XXX XXX X XXX XXXXXXX X X XXX X XXX X X XXXXXXX X X X X XXXXXXX XXXXX XXX XXXXXXX XXXXX XXX X XXX XXXXXXXXXXXXX X X XXX XXX X X XXX XXX X X X
X X X   X   X         X X   X   X X   X X     X   X X     X X X X X X       X X     X   X X X   X X X   X   X X X X X X   X X X     X     X X X   X   X X X     X   X       X X X X X X       X     X   X
X X X XXX XXXXXXX XXX X X XXX XXX XXX XXXXX XXX XXXXX X XXX X X X XXXXX XXXXX XXXXXXXXXXX X XXX X X X X X XXXXXXXXXXX XXX X X X XXX XXXXXXX XXX XXXXX X XXX XXX X X XXXXX XXX X X XXX X X XXXXX XXXXXXX X
X X       X X       X X     X X   X         X X X X   X X     X   X X             X     X X X   X   X X     X X             X   X       X       X   X     X X     X     X   X X X X     X X   X   X   X X
X X XXXXXXX XXXXXXXXX XXX X X XXXXXXX X XXXXX X X X XXX X X X XXX X X XXXXX X XXX XXXXX X XXXXXXXXX XXX XXXXX X XXXXX X X XXX XXX X XXXXXXX X X X XXX X XXXXX XXX X XXXXXXX XXXXX X XXXXX XXX X XXX XXX X
X   X         X X   X X   X   X   X   X     X     X X X X X X       X X   X X X X X   X       X X     X             X X X X     X X X   X X X X X     X     X X X X       X X           X   X   X       X
X XXXXX XXXXXXX X XXXXXXXXX XXX X XXX X XXXXXXXXX XXX XXXXXXXXXXX XXX XXX XXXXX X X X X XXXXX X XXX XXX XXX X XXX XXXXX X XXX XXXXX XXX X XXX X XXXXX X XXX XXX X XXXXX XXXXXXXXX X XXXXX X XXXXX X XXXXX
X         X   X   X   X   X X   X   X X     X         X X     X           X       X X   X   X   X X X   X   X X X X X   X   X X   X   X X     X X X X X X X     X X   X     X X X X   X   X       X     X
XXX XXXXX X X XXX XXX X XXX X XXX X X X XXXXXXX XXXXXXX X XXXXXXXXX XXXXXXX XXX XXX X XXX XXXXX X XXXXXXX X XXX XXX XXX XXX X X XXXXX X XXX XXX X X XXXXX XXXXX XXXXX XXX XXX X XXX XXX XXX XXXXX X X XXX
X   X   X X X               X X   X   X X         X         X             X X     X X   X   X   X X     X X       X   X X   X   X       X   X                 X           X           X   X     X X X   X
X XXX XXXXX X XXX X XXXXXXX XXXXX X X XXX XXXXX X X XXXXX XXXXX XXXXX X XXXXXXXXXXXXXXX XXX X XXX XXXXX XXXXXXX XXX X XXXXXXX X X XXX X X X XXXXXXX XXX X XXXXXXXXX XXXXX XXX XXXXX XXX XXXXXXX XXXXXXX X
X   X X     X   X X       X   X   X X X   X X X X   X X   X       X X X   X     X   X   X   X               X   X X X X X X   X X   X X   X       X   X X     X X X X X       X   X   X     X X   X X   X
X XXX X XXX XXX XXXXX XXX XXXXX XXX XXXXX X X XXXXX X XXXXXXX XXX X XXXXXXXXX X X XXX X X X XXXXXXX X XXX XXX XXX XXX X X X XXXXXXX XXXXX X XXXXX XXXXX X XXX X X XXX X XXXXX X X XXX XXXXXXX XXXXX X XXX
X   X   X     X     X   X X   X   X X X       X X   X   X       X         X   X     X X X X   X     X X X       X     X       X X X     X X X     X   X X X X   X   X   X     X X   X     X             X
XXX XXXXX X XXXXXXX X XXXXXXX XXX XXX XXXXX XXX X X XXX XXXXX X XXX XXXXX X XXX XXXXXXX X XXX X XXXXX X XXX X X X XXXXXXXXXXXXX X XXX XXXXX XXXXXXX X XXX X XXX X XXXXX XXXXX X XXX XXX X XXXXX X XXXXXXX
X   X   X X   X     X   X X X   X       X     X X X     X     X   X X X   X   X X       X X X       X X     X X   X     X X             X X X     X X X       X     X X X     X   X X X X X     X X     X
X X X XXXXX XXXXX X XXXXX X XXX X XXXXXXXXX XXX XXXXXXXXXXXXXXXXXXXXX XXX XXXXX XXXXXXXXX X X XXX XXXXXXX XXX XXX XXXXX X X XXX XXXXXXXXX X XXXXX XXX X XXXXXXX XXX X XXX X XXX XXX X X XXXXXXX X X X X X
X X X   X   X X X X X X X X X       X       X   X       X   X       X     X X           X   X X   X X       X X   X   X   X X             X         X   X     X X X     X X     X X X   X     X X   X X X
XXXXXXX X XXX X X XXX X X X XXX XXXXX XXX XXXXX X XXXXX X X XXXXXXX X XXXXX XXXXX XXX XXX XXXXXXX X XXXXXXX XXXXX X XXX XXXXXXXXXXXXXXXXXXXXXXXXX XXXXXXX X XXXXX XXXXX X X XXX X XXXXX XXX X XXX XXX X X
X     X   X         X   X X       X   X   X   X     X X   X   X   X   X       X X X X     X     X X     X       X X X     X X X   X   X                   X X       X     X X   X           X   X X   X X
XXXXX XXX XXXXXXXXX X X X X X XXXXXXXXX X X X XXXXX X X X X XXX XXX XXX XXXXX X XXX XXXXX XXX X XXX XXXXXXX X XXX X XXX XXX X XXX XXX XXXXXXX XXXXXXX XXXXX X XXXXX X XXXXXXXXX X XXXXXXXXXXXXXXXXXXXXX X
X X   X X     X     X X     X       X X X   X   X   X   X X X       X       X   X X       X   X X   X       X   X X       X   X   X   X   X   X       X   X   X   X X   X   X X X X X         X X     X X
X X XXX XXX XXX XXX XXXXX XXX X X X X XXX XXX XXX XXXXXXXXXXXXX X XXXXXXXXXXX X X X XXXXXXXXX XXX XXXXXXXXXXX XXX X XXXXXXX X X X X XXX XXXXX XXX XXXXX XXX XXXXX XXX XXX XXX XXXXX X XXXXX XXX X XXXXX X
X     X X X X   X     X   X   X X X X   X   X X   X     X   X X X     X     X X   X   X   X X   X     X X   X X   X       X X X X     X         X     X   X X     X   X   X     X X   X     X       X   X
X XXX X X X XXXXX XXXXX X X XXXXXXX X XXX XXXXX XXX XXXXXXX X X X XXXXXXX XXX XXXXXXX XXX X X X XXX XXX X X XXXXX X XXXXX XXX XXXXXXX XXX X X XXXXX X XXX X XXX X XXX X X XXX XXX X X X XXXXXXXXXXX XXX X
X   X   X       X     X X X       X   X   X   X   X X       X   X     X X   X       X X X     X X X     X X           X         X X     X X X X   X X   X X     X   X X X X X       X X   X         X X X
X XXX X X XXXXX XXX X XXX XXX X X X XXXXX X XXXXX X X X XXXXXXX XXXXXXX XXX XXX X XXX X X X XXXXX XXX XXX XXXXX XXX XXXXXXX X X X X X X X XXXXX XXXXXXX X X X X XXX XXXXX X XXX XXXXX X XXX XXXXXXXXX X X
X X   X X X       X X X     X X X X           X     X X X X         X   X   X   X       X X   X             X   X X X X X X X X X   X X X X               X X X   X X         X     X X X X X X   X     X
X X XXXXXXX XXXXX X XXXXXXX XXX XXXXXXXXXXX XXXXXXX X X X XXX XXXXXXX XXX XXX XXX X XXX XXX X XXXXXXXXXXX X X XXX X X X X X X X X X XXX XXXXXXX X XXXXXXX X XXX XXX XXXXXXX XXX XXX X X X X X X XXX XXXXX
X X X X   X X     X   X     X X   X X         X       X   X       X     X     X   X X   X   X X X       X X X X X X   X X X X X X X   X X       X X     X X   X X   X X   X X   X X X X X X       X   X X
X XXX XXX XXX XXXXXXX XXXXX X XXX X XXXXXXX XXXXXXXXXXX X X XXX X X XXXXX XXX XXXXX XXX XXX XXX X XXXXXXXXXXX X X XXX X X XXX XXX X XXXXX XXXXX XXX XXX XXXXXXXXXXXXX X XXX XXXXX X XXXXX XXX XXX X XXX X
X       X       X X X X X   X   X         X     X   X X X X X X X     X   X     X     X X     X         X X   X X           X     X X   X     X     X X   X X               X X           X   X     X   X
X XXX XXXXXXX XXX X XXX XXX X X XXXXXXXXX XXX XXX X X X XXX X X XXXXXXXXXXX XXXXXXXXXXX X X X X XXX X XXX X XXX XXXXXXXXXXXXXXXXXXXXXXX XXXXX X XXX X XXX X XXX XXX X X XXXXX XXXXX X X XXX XXXXXXX XXX X
X X X X       X       X       X X   X       X X   X X X     X         X           X   X X X X X X   X   X X   X       X   X           X     X X   X   X X X     X X X X   X X     X X X X X X     X     X
X X X X X XXXXX XXX X X XXX XXX X X X XXXXXXXXX XXXXX XXX X X XXXXXXX X XXX XXXXXXX X X X X XXX XXX XXXXX X X X XXXXX X XXX XXXXX X XXX X XXXXX XXX XXX XXXXXXX X XXXXXXXXX XXXXX X XXXXX XXXXX X X XXXXX
X X   X X       X   X     X X     X X X X   X X X     X   X X     X X X X     X     X     X X X   X     X   X X   X X       X     X X X X   X     X   X X     X X   X     X X X           X X   X   X   X
XXXXX XXX XXX XXXXX XXXXXXXXX XXXXX XXX X X X X X X XXXXXXXXXXX XXX XXX X XXXXXXXXXXX X XXX X XXX XXXXXXX XXXXX XXX XXXXXXXXX XXX XXX X XXXXXXX XXX XXX XXXXX X XXX X XXX X X XXXXX XXXXXXX X XXX X X X X
X   X     X   X X   X X     X   X       X X   X   X   X   X       X   X X   X X   X   X   X X X   X   X X X   X X   X   X   X X   X X X X       X           X     X   X     X   X X   X X X X X X X   X X
XXX XXXXXXXXXXX XXXXX X XXX X XXXXX XXX XXX X XXX XXXXX X XXXXX X X XXXXX X X XXX XXXXX XXX X X XXXXX X X X XXX X XXX XXX X X X X X X X X XXXXX XXX XXX XXXXXXX XXXXXXXXX XXX XXX X XXX X X XXX XXXXXXX X
X       X X   X X   X     X       X   X   X X     X     X X   X X X     X X X X     X X X     X     X X       X X   X     X X X X   X X   X     X     X X       X           X     X   X X X X X     X X X
XXXXXXX X X XXX XXX XXXXXXX XXXXXXXXXXX X XXXXX X X X XXX X XXXXXXX XXX XXX X X X X X X XXX X XXX XXX XXXXXXX X X XXXXX X XXXXX XXXXX X XXXXXXXXXXX X X XXXXX XXXXXXXXX XXXXX XXXXXXX X X X X X XXXXX X X
X         X     X   X   X     X   X X   X     X X   X   X         X X   X   X   X X   X   X X X   X   X     X X   X X   X   X     X     X     X     X X X   X     X       X X X X X         X   X   X X X
X XXXXX X XXX XXX XXXXX X XXX X X X XXXXX XXXXX XXX XXXXXXX X XXXXXXXXX XXXXXXXXXXX XXX X XXX X XXX XXXXX X XXX X X X XXXXX X XXX XXXXXXXXX XXXXXXXXXXX X XXX X X XXX X XXX X X X XXXXXXX X X X XXX X X X
X   X X X X   X       X     X   X X       X X   X   X X X   X X   X   X         X   X X X X X       X   X X X X X X   X X   X X X   X   X     X X     X       X X     X X X     X X   X X X   X   X   X X
X X X X X X X X X X XXXXXXXXXXX XXXXXXX X X X X XXXXX X X X XXX XXX XXXXXXX XXX X XXX X XXX XXX XXX X XXXXX X XXX X X X X X X X XXXXX XXXXXXX X XXX XXX XXXXXXXXX XXX X X X XXXXX X XXX X XXXXXXXXX XXX X
X X X   X   X   X X         X     X   X X   X X   X   X   X X X   X   X   X X X X         X   X   X X   X X   X   X X   X X X           X           X   X           X X     X   X                     X X
X XXX XXX XXXXX X X X XXX XXX XXX XXX XXXXX XXX XXX XXX X XXX X X X X X XXXXX X X XXXXXXX X X XXX XXXXX X X XXX X XXX X XXXXXXXXXXX X XXX XXXXXXX XXXXX XXXXX X X X XXX XXXXXXX XXX XXXXX XXX X X XXXXX X
X   X X   X   X X X X X     X X   X X   X   X   X X X   X   X   X X X X X X   X X X X     X X   X X           X X X X X   X   X     X   X X     X   X     X X X X X   X X     X     X     X   X X   X   X
X XXXXX XXXXX XXX XXXXXXXXX X X XXX XXX XXX XXXXX X XXX X X X XXXXXXX X X X X X XXX X X XXXXX XXXXXXXXX XXXXX X X X X XXXXX XXXXXXX XXXXX X X XXX X X XXX X X XXXXX XXX XXXXX XXXXXXXXX XXX X XXX XXX X X
X X   X       X X   X     X   X     X                 X X X   X X   X     X X     X   X   X X X X     X X     X X X X X     X         X   X X X   X X X     X X X   X   X X       X   X   X X X     X X X
X XXX X XXXXXXX XXXXXXXXX X X XXXXX XXXXXXXXXXX XXX XXX XXX X X X X X XXX XXXXXXX X XXX XXX X X XXX XXX XXXXX XXX X X X XXXXXXXXXXX X X XXX XXXXX XXXXX XXX X X X XXXXXXX X XXXXX X X XXXXXXXXXXXXX X XXX
X X     X X     X       X   X X   X   X X     X X   X X   X X   X X     X X X     X X X           X   X     X     X     X     X     X   X X X         X X   X   X   X X   X   X X X X                   X
XXX XXX X XXX X X XXX XXXXXXX XXX XXX X XXX X XXX XXX XXX XXXXX X XXXXXXX X XXX XXX X XXXXXXXXXXXXX XXXXX XXXXX XXX XXX X X XXX XXX XXXXX X X XXX XXX X XXXXXXX X X X XXX XXX X X X XXXXX XXX X XXX X XXX
X     X     X X X X X     X X X     X     X X   X X           X     X X   X       X X X X           X   X   X X   X   X   X     X     X       X   X X   X   X   X X X     X     X       X   X X   X X X X
XXXXX XXXXXXX XXX X X XXXXX X X X X X XXX XXXXX X XXXXXXX X X X X X X XXX XXXXX X X X X X XXXXXXXXXXXXX X X X X XXXXXXX X X X XXXXXXXXXXXXXXX XXXXX XXX X XXX XXXXX XXX XXX XXXXXXX X XXXXX XXX X XXXXX X
X     X X         X     X   X   X X X   X X X     X X X   X X X X X   X       X X   X X X   X X       X   X   X   X X   X X X   X X     X   X X   X     X X X X   X       X   X   X X   X     X X X X X X
XXXXX X XXXXX X XXX XXX X XXXXXXX XXX XXXXX XXX X X X X XXX XXXXX X XXXXXXXXXXXXXXX X X X XXX X XXX XXXXXXX X XXXXX X X X XXXXXXX X XXXXXXX X X X X XXXXX X X X X X XXXXX XXXXXXX X XXX XXX X X XXX X X X
X     X   X   X   X   X X   X   X X X   X       X     X   X   X   X X X     X   X             X   X       X X     X   X X   X           X X   X X   X   X X X X X       X   X X   X   X X X X X X X X   X
X X XXX X X X XXX XXXXXXX XXX XXXXX XXXXX XXX X XXX X XXXXX XXXXX XXX XXX X X X X XXXXXXXXXXX XXX XXXXXXXXXXX X XXXXXXXXXXXXX XXXXX X XXX XXX XXXXXXX X X X X XXXXXXXXXXXXXXX XXX XXXXXXX X XXX X X X X X
X X X X X X X   X     X X           X X   X X X   X X X         X   X     X   X X           X   X X   X       X     X         X     X X       X     X X   X       X   X         X X   X X     X X   X X X
XXX X X X XXX X X X X X X XXXXXXX XXX X XXX XXXXX XXX X XXXXX XXXXXXXXX XXXXXXXXX XXXXXXXXXXXXX X XXX XXXXX X XXXXX XXX X X XXXXX X XXXXX X XXXXX XXX XXXXXXX XXXXX XXXXXXXXX XXX X XXX XXXXX XXXXX XXX X
X X X   X   X X X X X       X   X       X   X     X       X         X                     X   X   X         X   X   X X X X     X X       X       X       X   X X             X           X     X       X
X X XXXXX XXXXXXX XXXXX XXX XXX XXXXX X X XXX XXXXXXXXX XXXXX XXX X X XXX XXX X XXXXXXX XXX XXX X XXX X XXX XXXXXXX X XXX XXXXX X X XXXXXXX X X XXXXX X X XXXXX X XXX XXX XXX X XXXXXXX XXX X XXXXXXXXX X
X               X     X   X   X       X     X       X       X   X X X X   X   X   X     X       X     X   X     X     X   X     X X       X X X       X X   X       X X     X         X     X           X
XXXXXXXXXXXXXXXXXXXXXXXXXXXXXXXXXXXXXXXXXXXXXXXXXXXXXXXXXXXXXXXXXXXXXXXXXXXXXXXXXXXXXXXXXXXXXXXXXXXXXXXXXXXXXXXXXXXXXXXXXXXXXXXXXXXXXXXXXXXXXXXXXXXXXXXXXXXXXXXXXXXXXXXXXXXXXXXXXXXXXXXXXXXXXXXXXXXXXXXXX
